00000000
eaaaaaab
071c71c7
80000000
f1c71c72
58e38e39
38e38e39
31c71c72
00000000
9c71c71c
d5555555
18e38e39
1c71c71c
2aaaaaab
1c71c71c
8aaaaaab
00000000
15555555
f8e38e39
80000000
0e38e38e
a71c71c7
c71c71c7
ce38e38e
00000000
638e38e4
2aaaaaab
e71c71c7
e38e38e4
d5555555
e38e38e4
75555555
