00000000
59249249
f2492492
92492492
e4924925
09249249
36db6db7
80000000
09249249
a4924925
c9249249
bb6db6db
1b6db6db
76db6db7
1b6db6db
cdb6db6e
00000000
a6db6db7
0db6db6e
6db6db6e
1b6db6db
f6db6db7
c9249249
80000000
f6db6db7
5b6db6db
36db6db7
44924925
e4924925
89249249
e4924925
32492492
